1 1 1 1 1 1 1 1 1 1 1 1 1 1 1 1 1,
1 6 3 0 0 0 0 0 2 0 0 0 0 0 3 7 1,
1 3 1 0 1 0 1 0 1 0 1 0 1 0 1 3 1,
1 0 0 0 0 0 0 0 2 0 0 0 0 0 0 0 1,
1 0 1 0 1 0 1 0 1 0 1 0 1 0 1 0 1,
1 0 0 0 0 0 0 0 2 0 0 0 0 0 0 0 1,
1 0 1 0 1 0 1 0 1 0 1 0 1 0 1 0 1,
1 0 0 0 0 0 0 0 2 0 0 0 0 0 0 0 1,
1 2 1 2 1 2 1 2 1 2 1 2 1 2 1 2 1,
1 0 0 0 0 0 0 0 2 0 0 0 0 0 0 0 1,
1 0 1 0 1 0 1 0 1 0 1 0 1 0 1 0 1,
1 0 0 0 0 0 0 0 2 0 0 0 0 0 0 0 1,
1 0 1 0 1 0 1 0 1 0 1 0 1 0 1 0 1,
1 0 0 0 0 0 0 0 2 0 0 0 0 0 0 0 1,
1 3 1 0 1 0 1 0 1 0 1 0 1 0 1 3 1,
1 8 3 0 0 0 0 0 2 0 0 0 0 0 3 9 1,
1 1 1 1 1 1 1 1 1 1 1 1 1 1 1 1 1
